5 1 0 1 1 3 3 5
5 0 1 4 5 0 3 1
4 1 2 5 1 0 2 2
3 5 4 2 0 1 5 1
5 1 0 5 0 3 2 4