3 2 3 0 1 2 4 1
0 0 3 4 2 1 2 2
4 2 1 1 1 0 0 3
2 0 1 3 0 4 0 0
4 1 3 4 0 2 2 1
